Humans: 1000
GGGGGGGGGGGGGGGGGGGGGGGGGGGGGGGGGGGGGGGGGGGGGGGGGGGGGGGGGGGGGGGGGGGGGGGGGGGGGGGGGGGGGGGGGGGGGGGGGGGGGGGG
G....P..............................P......P.................P.........................................G
G.@..P...........................Z..P....Z.P.................P.Z.......................................G
G....P.....PPPPPPPPPPPPPPPPR.RPPPGPPP......P.................P.........................................G
RR..RP.....PPPPPPPPP................P......P.................PPPPPPPPPPPPPPPPPPR.RPPPPPPPPPPGPPPPPPPPPPG
GP..P......PPPPPPPGP................P......P...........................................................G
GP..P......PPPPPPPPP................P......P........PPPPPP..............................PPPPPP.........G
GP..P......RPPPPPPPP................P......P........P....P..............................P....P.........G
G..........RPPPPPPPP................P......P.........P....P............................P....P..........G
G..........RPPPPPPPP................P......P..........P....P..........................P....P...........G
G..........RPPPPPPPP................P......P...........P....P........P.PPPPPP........P....P............G
G..........RPPPPPPGP................P......R............P....P......P.....Z..P......P....P.............G
GPPPPPPGPPPRPPPPPPPP................P....................P....P....P....PP....P....P....P..............G
G...................................P......R...PPPPPPPP...P....P..P....P..P....P..P....P...............G
G.Z.................................P......P...P......R....P....PP....P....P....PP....P................G
G...................................P......P...P......R.....P........P......P........P.................G
GPPPPPPPPPPGPPPPPPPPPPPPPPPPPPPPPR.RP......P...P......P......P......P........P......P..................G
G...................................P......P...P......P.......P....P..........P....P...................G
G...................................P......P...P......P.......PPPPPP..........PPPPPP...................G
G...................................P......P...P...P..P................................................G
G..PPPPPPPPPPPPPPPPPPPPPPPPPPPPPPPPPP......P...P...P..P........................................Z.......G
G...................................P......P...P...P..P................................................G
GPPPPPPPPPPPPPPPPPPPPPPPPPPPPPPR.RPPP......P...PP..P..PRR..RRGPPPPPPPPPPPPPPPPPPGPPPPPPPPPPPPPPPPPPPPPPG
G...................................P......P.......P..........P........................................G
G..PPPPPPPPPPPPPPPPPPPPPPPPPPPPPPPPPP......P.......P..............................................Z....G
G..........................................P.......P..........P........................................G
GGGGGGGGGGGGGGGGGGGGGGGGGGGGGGGGGGGGGGGGGGGGGGGGGGGGGGGGGGGGGGGGGGGGGGGGGGGGGGGGGGGGGGGGGGGGGGGGGGGGGGGG